


             
NO	./assets/tile.png

SO	 ./assets/tile.png

WE	  ./assets/tile.png

EA	 ./assets/tile.png

F 255,100,0

C 225,30,0


11111111111111111111111111111111
111101111100000000001100000000111
11111111011000001110000000000001111111111111
111111111111111111111111011111111111111111111
111101111001000000000000000000001000111111111
1111111011000001110000000000001000111111111
10000000111000001110111111111111000011111111
11111111000111010111000000100010000000011111111
111111111111110111010100100010000000011111111
100000000000000011000000100010000000000000011
100000000000000011000000100010000000011111111
100000000000000011010100100011000000011111111
10W000000000000011110111100011100000011111111
10000000000000001111011110100010000001111
11111111111111111111111111111111111111111111




			
