1111111111111
1P0C0000C0001
1000000000001
111111E111111
1111111111111
