1111111111111
1P11111111C11
1111111111111
111111E111111
1111111111111
