111111111
10P000001
100000001
100000001
10C000001
100000001
1000000E1
111111111
