11111111111111111111
11111111111111111111
111111111111111C1111
111111111111111P1111
1111hello111111E1111
11111111111111111111
