1111111111111111111
1111111111111111111
1111111111111111111
1P11111111111111CE1
1111111111111111111
1
