1
11111111111111111111111111
10C00000000000000000000E01
11111111111111111111111111
