1111111111111111111111111
1111111111111111111111111
1111111111111111111111111
1111111111111111111111111
111111111111111111111111111111
1111111111111111111111111
10P000000000E0000C0000001
1111111111111111111111111
