11111111111111
11111111111111
11111111111111
1E1111111111C1
11111111111111
