


             
NO	./assets/BrickBlue.png

SO	 ./assets/Dirt.png

WE	  ./assets/Metal.png

EA	 ./assets/WoodLight.png

F 255,100,0

C 225,30,0


11111111111111111111
1N0000000000000000N1
10000000000000000001
10000000000000000001
10000000000000000001
10000000000000000001
11111111111111111111
			