


             
NO	./assets/tile.png

SO	 ./assets/tile.png

WE	  ./assets/tile.png

EA	 ./assets/tile.png

F 255,100,0

C 225,30,0


11111111111111111111
1E0000000000000000E1111111111111111111111111111
10000000000000000001
10000000000000000001
10000000000000000001
10000000000000000001
11111111111111111111
aaaaaaaaaaaaaaaaaaaaaa
a
a














