NO	./assets/Diamon.png

SO	 ./assets/Snow.png

WE	  ./assets/Tile2.png

EA	 ./assets/Wood.png

F 255,100,0

C 225,30,0


11111111111111111111
10000000000000100001
10000000000000100001
10000000000000100001
10000000000000100111
10000000000000100001
10000000000000111101
10000000000000100001
10000000000000101111
10000000000000100001
100000000000001111W1
10000000000000000001
10000000000000000001
10000000000000000001
10000000000000000001
10000000000000000001
10000000000000000001
11111111111111111111
			
