


             
NO	./assets/BrickGrey.png

SO	 ./assets/Dirt.png

WE	  ./assets/Metal.png

EA	 ./assets/Lava.png

F 255,100,0

C 225,30,0


11111111111111111111
100000000000001000S1
10000001110000100001
10111001110000100001
10111000000000100001
10000000001100011101
10000000001100000001
11111111111111111111
